.#########
.##...@..#
..#......#
###...#..#
#.......##
##.###.##
#...#...#
##.######
#.......#
#########